################
#X#   G@       #
# #            #
# #          # #
# #          # #
# #          # #
# #          # #
# #      C   # #
# #          # #
# #          # #
# #     S    # #
# #          # #
# #          # #
# ############ #
#              #
################
