################
#L     @       #
#      X      G#
#  ooooo########
#              #
# C          ss#
#           #ss#
#           #ss#
#   C       #ss#
#          L#ss#
#           #ss#
# C   C     #ss#
#           #dd#
#   C    ####dd#
#V       #ddddV#
################
