################
#X#   G@L      #
# #            #
# #          # #
# #          # #
# #          # #
# #          # #
# #          # #
# #          # #
# #          # #
# #          # #
# #    S     # #
# #          # #
# ############ #
#              #
################
